inwi	BRAND
orange	BRAND
سلطان	BRAND
IAM	BRAND
3g	TECHNOLOGY
4g	TECHNOLOGY
adsl	TECHNOLOGY
HD	TECHNOLOGY
ultra	GROUP OF PEOPLE
الرجاء	SOCCER CLUB
مشكل	NEGATIVE
شهر	TEMPORAL:TIME
مبروك	POSITIVE
بصحتكم	POSITIVE
زوين	POSITIVE
تافراوت	LOCATION
المغرب	LOCATION
tom	PERSON
jerry	PERSON
قذافي	PERSON
القذافي	PERSON
Renault	CAR BRAND
Dacia	CAR BRAND
logan	CAR MODEL
diesel	CAR FUEL
الله ينصرك	POSITIVE
الله ياخد فيهم الحق	NEGATIVE